0 0 0 0 0 0 0 0 0 0 0 0 1 1 0 0 0 0 0 0 0 0 0 0 0 0 0 1 1 1 1 1 1 1 1 1 1 1 1 1
0 0 0 0 0 0 0 0 0 0 0 0 1 1 0 0 0 0 0 0 0 0 0 0 0 0 0 1 1 1 1 1 1 1 1 1 1 1 1 1
0 0 0 0 0 0 0 0 0 0 0 0 1 1 0 0 0 0 0 0 0 0 0 0 0 0 0 1 1 1 1 1 1 1 1 1 1 1 1 1
0 0 0 0 0 0 0 0 0 0 0 0 1 5 0 0 A 0 0 0 0 0 0 0 0 0 0 4 1 1 1 1 1 1 1 1 1 1 1 1
0 0 0 0 0 0 0 0 0 0 0 0 6 1 1 1 1 1 1 0 0 1 1 1 0 0 0 1 1 1 1 1 1 1 1 1 1 1 1 1
1 4 3 1 1 1 0 0 5 1 0 0 1 1 0 0 0 0 0 0 1 1 3 1 0 0 0 4 1 1 1 1 1 1 1 1 1 1 1 1
5 1 1 4 4 5 0 0 4 3 0 0 5 1 0 0 0 0 0 1 1 1 1 1 0 0 0 1 1 1 1 1 1 1 1 1 1 1 1 1
1 1 4 2 1 1 A A 4 7 0 0 1 1 0 0 0 0 1 1 3 1 1 1 A 0 A 1 1 1 1 1 1 1 1 1 1 1 1 1
1 1 1 1 1 1 1 1 1 1 0 0 1 1 0 0 0 5 1 1 1 1 1 1 1 0 1 1 1 4 1 1 1 1 1 1 1 1 1 1
4 2 1 0 0 0 0 0 0 0 0 0 0 0 0 0 1 2 1 1 2 1 1 1 1 0 1 1 1 1 1 1 1 1 1 1 1 1 1 1
1 1 1 0 0 0 0 0 0 0 0 0 0 0 0 5 1 1 1 1 1 1 1 4 2 0 1 1 1 1 1 5 1 6 1 1 5 1 4 1
1 6 1 0 0 0 0 A 0 0 0 0 0 0 1 1 3 1 1 1 1 1 0 0 0 0 0 0 0 0 0 0 0 0 0 0 0 1 1 1
1 1 1 0 0 1 1 1 1 3 0 0 1 1 1 5 1 1 1 1 1 1 1 1 1 0 1 1 1 0 0 0 0 0 0 0 0 1 1 1
1 5 1 0 0 1 1 1 1 1 0 0 1 3 1 1 1 2 1 1 1 2 1 1 1 0 1 4 1 0 0 0 0 0 0 0 0 1 1 1
2 1 1 0 0 0 0 0 0 0 0 0 1 1 6 1 1 1 1 1 1 1 1 1 1 0 1 1 1 0 0 0 0 0 0 0 0 4 1 1
1 2 4 0 0 0 0 0 0 0 0 0 1 1 5 1 1 3 6 3 1 5 5 1 1 B 1 1 1 B B B B B B B B 1 1 1
1 1 3 B B 1 1 1 1 1 2 1 1 1 1 1 1 1 1 1 3 1 1 2 1 1 1 3 1 1 1 1 5 1 1 1 1 1 1 1
1 1 1 1 1 1 1 1 3 1 1 6 1 1 4 1 1 1 1 4 1 1 1 1 1 1 1 1 1 2 1 1 1 1 1 2 1 1 1 1
1 1 1 1 1 2 1 1 1 1 3 1 1 1 1 1 1 6 1 1 1 4 1 3 1 1 1 3 1 1 1 1 3 1 1 1 1 1 1 1
1 1 1 1 1 1 1 6 1 1 1 1 1 2 1 1 3 1 1 3 1 1 1 1 1 1 1 1 1 4 1 1 1 6 1 1 3 1 1 1